%%%%%%%
%    P%
% %%% %
%     %
%%   %%
%     %
%%%%%%%
